"","CLASSNAME","ACRES_CURR","AG","DEV","ACRES_HIST","DIFF","PER_CHANGE"
"1","Acadian-Appalachian Alpine Tundra",40728,3,495,41226,498,1.21
"2","Acadian-Appalachian Montane Spruce-Fir Forest",2659221,5913,31373,2696508,37287,1.38
"3","Acadian-Appalachian Subalpine Woodland and Heath-Krummholz",76085,68,418,76571,486,0.63
"4","Acadian Low-Elevation Spruce-Fir-Hardwood Forest",9129393,456988,518196,10104576,975183,9.65
"5","Alabama Ketona Glade and Woodland",43718,3073,5467,52258,8540,16.34
"6","Allegheny-Cumberland Dry Oak Forest and Woodland",12945112,2864528,2104281,17913921,4968809,27.74
"7","Apacherian-Chihuahuan Mesquite Upland Scrub",1064475,16528,20448,1101451,36976,3.36
"8","Apacherian-Chihuahuan Semi-Desert Grassland and Steppe",18558663,188452,294865,19041979,483316,2.54
"9","Appalachian (Hemlock-)Northern Hardwood Forest",8066300,1492061,2110001,11668362,3602062,30.87
"10","Appalachian Shale Barrens",2564,2,124,2689,125,4.65
"11","Arkansas Valley Prairie and Woodland - Prairie",191846,391005,115771,698623,506777,72.54
"12","Arkansas Valley Prairie and Woodland - Woodland",290737,217851,87208,595796,305059,51.2
"13","Atlantic Coastal Plain Clay-Based Carolina Bay Wetland",80858,4792,2001,87651,6793,7.75
"14","Atlantic Coastal Plain Dry and Dry-Mesic Oak Forest",1335824,354655,347269,2037748,701924,34.45
"15","Atlantic Coastal Plain Fall-line Sandhills Longleaf Pine Woodland",2435881,427299,929125,3792305,1356424,35.77
"16","Atlantic Coastal Plain Mesic Hardwood Forest",3610842,1800106,1430872,6841820,3230978,47.22
"17","Atlantic Coastal Plain Peatland Pocosin and Canebrake",1098485,87403,103654,1289541,191056,14.82
"18","Atlantic Coastal Plain Streamhead Seepage Swamp-Pocosin-Baygall",509657,19898,35572,565126,55469,9.82
"19","Atlantic Coastal Plain Upland Longleaf Pine Woodland",7092227,5038605,3092774,15223606,8131379,53.41
"20","Bluegrass Savanna and Woodland",44343,218967,40153,303463,259120,85.39
"21","Boreal Acid Peatland Systems",1354836,1011,7920,1363768,8932,0.65
"22","Boreal Acidic Peatland Systems",7061297,133931,179516,7374743,313446,4.25
"23","Boreal Aspen-Birch Forest",69309,12590,9930,91829,22520,24.52
"24","Boreal Jack Pine-Black Spruce Forest",750674,1319,16716,768709,18035,2.35
"25","Boreal White Spruce-Fir-Hardwood Forest - Aspen-Birch",2815263,181584,229547,3226394,411131,12.74
"26","Boreal White Spruce-Fir-Hardwood Forest - Coastal",939128,128299,178032,1245459,306331,24.6
"27","Boreal White Spruce-Fir-Hardwood Forest - Inland",3690781,301066,383726,4375574,684793,15.65
"28","California Central Valley and Southern Coastal Grassland",468824,302547,601776,1373147,904323,65.86
"29","California Central Valley Mixed Oak Savanna",381516,656380,351416,1389312,1007796,72.54
"30","California Central Valley Riparian Woodland and Shrubland",224785,2967294,725012,3917092,3692307,94.26
"31","California Coastal Closed-Cone Conifer Forest and Woodland",4941,6,991,5939,998,16.8
"32","California Coastal Live Oak Woodland and Savanna",624940,42671,200988,868600,243660,28.05
"33","California Coastal Redwood Forest",2467450,16485,145837,2629771,162321,6.17
"34","California Lower Montane Blue Oak-Foothill Pine Woodland and Savanna",6238653,664612,906653,7809918,1571265,20.12
"35","California Maritime Chaparral",11330,8,9484,20823,9493,45.59
"36","California Mesic Chaparral",940538,5911,50336,996785,56247,5.64
"37","California Mesic Serpentine Grassland",9118,1,561,9680,562,5.81
"38","California Montane Jeffrey Pine(-Ponderosa Pine) Woodland",3444164,4310,50562,3499036,54872,1.57
"39","California Montane Riparian Systems",2083147,87602,342604,2513353,430206,17.12
"40","California Montane Woodland and Chaparral",466460,6939,14441,487839,21379,4.38
"41","California Northern Coastal Grassland",35052,3010,40171,78233,43181,55.2
"42","California Xeric Serpentine Chaparral",33337,291,3362,36989,3652,9.87
"43","Caribbean Coastal Wetland Systems",232469,38,778,233285,816,0.35
"44","Caribbean Swamp Systems",625118,16984,62726,704828,79710,11.31
"45","Central and South Texas Coastal Fringe Forest and Woodland",869518,70365,211811,1151694,282176,24.5
"46","Central and Southern Appalachian Montane Oak Forest",1669510,60713,82596,1812819,143309,7.91
"47","Central and Southern Appalachian Spruce-Fir Forest",570091,2247,16541,588878,18787,3.19
"48","Central and Southern California Mixed Evergreen Woodland",2576750,66825,163511,2807085,230335,8.21
"49","Central and Upper Texas Coast Dune and Coastal Grassland",68923,1717,20664,91303,22380,24.51
"50","Central Appalachian Alkaline Glade and Woodland",73843,42478,33941,150262,76419,50.86
"51","Central Appalachian Dry Oak-Pine Forest",10119295,1476483,2938179,14533957,4414662,30.37
"52","Central Appalachian Pine-Oak Rocky Woodland",714920,39799,116419,871138,156218,17.93
"53","Central Atlantic Coastal Plain Maritime Forest",175022,4857,38223,218102,43080,19.75
"54","Central Atlantic Coastal Plain Nonriverine Swamp and Wet Hardwood Forest",681598,247973,111513,1041085,359487,34.53
"55","Central Atlantic Coastal Plain Wet Longleaf Pine Savanna and Flatwoods",1970296,434814,417140,2822250,851954,30.19
"56","Central Florida Pine Flatwoods",2689501,1127091,1491666,5308258,2618757,49.33
"57","Central Interior and Appalachian Floodplain Systems",8524692,8697460,3212630,20434782,11910090,58.28
"58","Central Interior and Appalachian Riparian Systems",10794384,3872637,2746612,17413633,6619249,38.01
"59","Central Interior and Appalachian Shrub-Herbaceous Wetland Systems",749628,203228,216712,1169568,419940,35.91
"60","Central Interior and Appalachian Swamp Systems",3350011,2199750,1098933,6648694,3298683,49.61
"61","Central Interior Highlands Calcareous Glade and Barrens",677268,520255,134838,1332362,655094,49.17
"62","Central Interior Highlands Dry Acidic Glade and Barrens",98429,103695,20548,222672,124243,55.8
"63","Central Mixedgrass Prairie",31734214,30854129,5595858,68184201,36449987,53.46
"64","Central Tallgrass Prairie",8799777,41790902,9078319,59668998,50869221,85.25
"65","Chihuahuan-Sonoran Desert Bottomland and Swale Grassland",918523,227105,119635,1265263,346740,27.4
"66","Chihuahuan-Sonoran Desert Bottomland and Swale Grassland - Alkali Sacaton",976737,40412,38409,1055559,78822,7.47
"67","Chihuahuan-Sonoran Desert Bottomland and Swale Grassland - Tobosa Grassland",1026262,47805,32198,1106266,80004,7.23
"68","Chihuahuan Creosotebush Desert Scrub",2252023,21939,34009,2307971,55948,2.42
"69","Chihuahuan Grama Grass-Creosote Steppe",3222860,28676,60838,3312373,89513,2.7
"70","Chihuahuan Gypsophilous Grassland and Steppe",1166377,57220,82154,1305750,139373,10.67
"71","Chihuahuan Loamy Plains Desert Grassland",6595103,362166,225116,7182386,587283,8.18
"72","Chihuahuan Mixed Desert and Thorn Scrub",1821449,3456,6092,1830998,9549,0.52
"73","Chihuahuan Mixed Desert Shrubland",1711995,30123,117428,1859545,147550,7.93
"74","Chihuahuan Mixed Salt Desert Scrub",689506,26897,19140,735543,46037,6.26
"75","Chihuahuan Sandy Plains Semi-Desert Grassland",2532794,14336,110731,2657860,125066,4.71
"76","Chihuahuan Stabilized Coppice Dune and Sand Flat Scrub",473944,21370,12490,507805,33861,6.67
"77","Chihuahuan Succulent Desert Scrub",6584065,114466,154224,6852755,268690,3.92
"78","Colorado Plateau Blackbrush-Mormon-tea Shrubland",1891911,1516,11441,1904868,12957,0.68
"79","Colorado Plateau Mixed Low Sagebrush Shrubland",2242099,24738,30445,2297282,55183,2.4
"80","Colorado Plateau Pinyon-Juniper Shrubland",113461,3722,6038,123221,9760,7.92
"81","Colorado Plateau Pinyon-Juniper Woodland",12337346,34137,87343,12458826,121480,0.98
"82","Columbia Basin Foothill and Canyon Dry Grassland",163335,96194,13085,272614,109279,40.09
"83","Columbia Basin Palouse Prairie",5034,94415,8092,107541,102507,95.32
"84","Columbia Plateau Low Sagebrush Steppe",871716,14419,17539,903674,31958,3.54
"85","Columbia Plateau Scabland Shrubland",1033694,98471,69067,1201233,167539,13.95
"86","Columbia Plateau Steppe and Grassland",9060441,4849930,803811,14714182,5653741,38.42
"87","Columbia Plateau Western Juniper Woodland and Savanna",1729626,56250,139430,1925306,195680,10.16
"88","Crosstimbers Oak Forest and Woodland",9661920,1390093,2087934,13139947,3478027,26.47
"89","East-Central Texas Plains Post Oak Savanna and Woodland",2829077,3016304,1097657,6943038,4113961,59.25
"90","East-Central Texas Plains Southern Pine Forest and Woodland",340233,2739,7863,350835,10602,3.02
"91","East Cascades Mesic Montane Mixed-Conifer Forest and Woodland",1589524,10295,53108,1652927,63403,3.84
"92","East Cascades Oak-Ponderosa Pine Forest and Woodland",528778,113054,77902,719735,190957,26.53
"93","East Gulf Coastal Plain Dune and Coastal Grassland",906,23,1626,2555,1649,64.54
"94","East Gulf Coastal Plain Interior Shortleaf Pine-Oak Forest",2855189,741762,598916,4195867,1340678,31.95
"95","East Gulf Coastal Plain Interior Upland Longleaf Pine Woodland",11101459,4346051,2856333,18303844,7202385,39.35
"96","East Gulf Coastal Plain Jackson Plain Prairie and Barrens",2455,9011,2417,13883,11428,82.32
"97","East Gulf Coastal Plain Limestone Forest",35714,70934,28876,135523,99809,73.65
"98","East Gulf Coastal Plain Maritime Forest",66781,9554,60642,136976,70195,51.25
"99","East Gulf Coastal Plain Near-Coast Pine Flatwoods",3069324,209784,628132,3907240,837916,21.45
"100","East Gulf Coastal Plain Northern Dry Upland Hardwood Forest",3286884,934057,631691,4852632,1565748,32.27
"101","East Gulf Coastal Plain Northern Loess Bluff Forest",940482,665077,353721,1959280,1018798,52
"102","East Gulf Coastal Plain Northern Loess Plain Oak-Hickory Upland",216152,626223,107017,949392,733240,77.23
"103","East Gulf Coastal Plain Northern Mesic Hardwood Slope Forest",393281,141201,91899,626380,233099,37.21
"104","East Gulf Coastal Plain Savanna and Wet Prairie",258018,49911,86576,394504,136486,34.6
"105","East Gulf Coastal Plain Southern Loblolly-Hardwood Flatwoods",467367,294715,155774,917855,450488,49.08
"106","East Gulf Coastal Plain Southern Loess Bluff Forest",469196,117682,153990,740868,271672,36.67
"107","Eastern Boreal Floodplain",797547,10580,21363,829490,31943,3.85
"108","Eastern Great Plains Floodplain Systems",1058861,2118634,846032,4023527,2964666,73.68
"109","Eastern Great Plains Tallgrass Aspen Parkland",260166,164326,107857,532349,272183,51.13
"110","Eastern Great Plains Wet Meadow-Prairie-Marsh",41818,401534,71778,515130,473312,91.88
"111","Eastern Highland Rim Prairie and Barrens",26628,40458,13269,80355,53727,66.86
"112","Eastern Serpentine Woodland",1050,6,148,1203,153,12.72
"113","Edwards Plateau Dry-Mesic Slope Forest and Woodland",2237916,4458,93731,2336105,98189,4.2
"114","Edwards Plateau Limestone Savanna and Woodland",9103709,176339,590579,9870627,766918,7.77
"115","Edwards Plateau Limestone Shrubland",4812760,14463,130409,4957632,144872,2.92
"116","Edwards Plateau Mesic Canyon",92169,41,3387,95597,3428,3.59
"117","Edwards Plateau Riparian",343614,5583,20249,369445,25831,6.99
"118","Florida Dry Prairie",396526,391758,100288,888573,492047,55.37
"119","Florida Longleaf Pine Sandhill",1360375,673799,1022032,3056206,1695831,55.49
"120","Florida Peninsula Inland Scrub",108930,138387,301032,548349,439419,80.13
"121","Floridian Highlands Freshwater Marsh",748049,57997,75962,882008,133959,15.19
"122","Great Basin Pinyon-Juniper Woodland",6184754,5797,13647,6204198,19444,0.31
"123","Great Basin Semi-Desert Chaparral",550437,1244,6439,558120,7683,1.38
"124","Great Basin Xeric Mixed Sagebrush Shrubland",22301739,89735,142006,22533480,231741,1.03
"125","Great Lakes Alvar",6543,7840,3691,18074,11531,63.8
"126","Great Lakes Coastal Marsh Systems",96879,76029,75400,248307,151428,60.98
"127","Great Lakes Pine Barrens",574522,1893,72187,648602,74080,11.42
"128","Great Lakes Spruce-Fir",52655,5327,7662,65645,12990,19.79
"129","Great Lakes Wet-Mesic Lakeplain Prairie",45149,104017,73271,222438,177289,79.7
"130","Great Lakes Wooded Dune and Swale",79819,7835,65683,153337,73518,47.95
"131","Great Plains Prairie Pothole",290295,384826,239859,914980,624685,68.27
"132","Gulf and Atlantic Coastal Plain Floodplain Systems",18959779,14692010,3350799,37002588,18042809,48.76
"133","Gulf and Atlantic Coastal Plain Small Stream Riparian Systems",10949562,2703584,1712321,15365467,4415905,28.74
"134","Gulf and Atlantic Coastal Plain Sparsely Vegetated Systems",167,32,4842,5041,4874,96.69
"135","Gulf and Atlantic Coastal Plain Swamp Systems",10117515,3864080,2079069,16060663,5943148,37
"136","Gulf and Atlantic Coastal Plain Tidal Marsh Systems",4608986,182998,440550,5232535,623549,11.92
"137","Inter-Mountain Basins Aspen-Mixed Conifer Forest and Woodland",5232675,2923,17011,5252609,19934,0.38
"138","Inter-Mountain Basins Aspen-Mixed Conifer Forest and Woodland - High Elevation",1342179,214,4687,1347081,4902,0.36
"139","Inter-Mountain Basins Aspen-Mixed Conifer Forest and Woodland - Low Elevation",664078,487,3880,668445,4367,0.65
"140","Inter-Mountain Basins Big Sagebrush Shrubland",27911698,1122594,831589,29865882,1954184,6.54
"141","Inter-Mountain Basins Big Sagebrush Shrubland - Basin Big Sagebrush",1587844,18125,34006,1639975,52131,3.18
"142","Inter-Mountain Basins Big Sagebrush Shrubland - Wyoming Big Sagebrush",19857304,276976,272463,20406743,549439,2.69
"143","Inter-Mountain Basins Big Sagebrush Steppe",32762770,4620681,1609800,38993252,6230482,15.98
"144","Inter-Mountain Basins Curl-leaf Mountain Mahogany Woodland and Shrubland",1811967,1878,7116,1820961,8994,0.49
"145","Inter-Mountain Basins Greasewood Flat",9064043,971221,626009,10661273,1597230,14.98
"146","Inter-Mountain Basins Juniper Savanna",506577,384,9555,516516,9939,1.92
"147","Inter-Mountain Basins Mat Saltbush Shrubland",2919190,155712,89853,3164754,245564,7.76
"148","Inter-Mountain Basins Mixed Salt Desert Scrub",29578830,657167,551649,30787646,1208816,3.93
"149","Inter-Mountain Basins Mixed Salt Desert Scrub - North",271497,13062,17712,302271,30774,10.18
"150","Inter-Mountain Basins Mixed Salt Desert Scrub - South",271111,7493,15627,294231,23120,7.86
"151","Inter-Mountain Basins Montane Riparian Systems",2768352,2238338,807573,5814263,3045911,52.39
"152","Inter-Mountain Basins Montane Sagebrush Steppe",25510128,1695422,893651,28099201,2589073,9.21
"153","Inter-Mountain Basins Montane Sagebrush Steppe - Low Sagebrush",507914,32559,24220,564693,56779,10.05
"154","Inter-Mountain Basins Montane Sagebrush Steppe - Mountain Big Sagebrush",3109331,178179,140130,3427640,318309,9.29
"155","Inter-Mountain Basins Semi-Desert Grassland",7315748,929677,423228,8668653,1352905,15.61
"156","Inter-Mountain Basins Semi-Desert Shrub-Steppe",4596557,81384,82031,4759972,163415,3.43
"157","Inter-Mountain Basins Sparsely Vegetated Systems",22101,146615,301999,470715,448614,95.3
"158","Inter-Mountain Basins Subalpine Limber-Bristlecone Pine Woodland",159749,28,278,160054,305,0.19
"159","Klamath-Siskiyou Lower Montane Serpentine Mixed Conifer Woodland",362666,247,12106,375019,12353,3.29
"160","Klamath-Siskiyou Upper Montane Serpentine Mixed Conifer Woodland",215383,4,3553,218940,3557,1.62
"161","Klamath-Siskiyou Xeromorphic Serpentine Savanna and Chaparral",27271,528,19706,47505,20234,42.59
"162","Laurentian-Acadian Alkaline Conifer-Hardwood Swamp",5857164,108560,97820,6063544,206380,3.4
"163","Laurentian-Acadian Floodplain Systems",2101756,281151,235803,2618710,516954,19.74
"164","Laurentian-Acadian Jack Pine Barrens and Forest",2256921,211647,330998,2799567,542646,19.38
"165","Laurentian-Acadian Northern Hardwoods Forest",25771052,7337397,3709624,36818074,11047022,30
"166","Laurentian-Acadian Northern Hardwoods Forest - Hemlock",4488647,835169,545815,5869632,1380985,23.53
"167","Laurentian-Acadian Northern Pine Forest",78645,453,6242,85341,6696,7.85
"168","Laurentian-Acadian Northern Pine(-Oak) Forest",6833533,1414728,1420548,9668810,2835277,29.32
"169","Laurentian-Acadian Pine-Hemlock-Hardwood Forest",7294736,1505619,915106,9715461,2420725,24.92
"170","Laurentian-Acadian Shrub-Herbaceous Wetland Systems",1668596,98299,165839,1932734,264138,13.67
"171","Laurentian-Acadian Swamp Systems",1772253,145078,146356,2063686,291433,14.12
"172","Laurentian Pine-Oak Barrens",1237980,124665,221877,1584521,346541,21.87
"173","Llano Uplift Acidic Forest-Woodland-Glade",583087,2444,32428,617960,34873,5.64
"174","Lower Mississippi Alluvial Plain Grand Prairie",39179,626810,53192,719181,680002,94.55
"175","Lower Mississippi River Dune Woodland and Forest",17090,244627,26018,287734,270644,94.06
"176","Lower Mississippi River Flatwoods",444503,2254031,259159,2957693,2513190,84.97
"177","Madrean Encinal",2625116,1439,21983,2648538,23422,0.88
"178","Madrean Juniper Savanna",379062,216,2198,381475,2413,0.63
"179","Madrean Lower Montane Pine-Oak Forest and Woodland",1632360,585,9578,1642522,10162,0.62
"180","Madrean Oriental Chaparral",54061,15,153,54229,168,0.31
"181","Madrean Pinyon-Juniper Woodland",2904136,2194,4229,2910559,6423,0.22
"182","Madrean Upper Montane Conifer-Oak Forest and Woodland",19746,4,21,19771,25,0.13
"183","Mediterranean California Alpine Dry Tundra",9110,NA,17,9126,16,0.18
"184","Mediterranean California Alpine Fell-Field",11942,NA,5,11947,5,0.04
"185","Mediterranean California Dry-Mesic Mixed Conifer Forest and Woodland",6090650,87336,239643,6417628,326978,5.09
"186","Mediterranean California Lower Montane Black Oak-Conifer Forest and Woodland",1157798,89883,123151,1370832,213034,15.54
"187","Mediterranean California Mesic Mixed Conifer Forest and Woodland",6981348,19227,119644,7120219,138871,1.95
"188","Mediterranean California Mesic Serpentine Woodland and Chaparral",66356,73,2059,68487,2131,3.11
"189","Mediterranean California Mixed Evergreen Forest",3122752,7641,112468,3242861,120109,3.7
"190","Mediterranean California Mixed Oak Woodland",1116503,16983,40414,1173901,57398,4.89
"191","Mediterranean California Red Fir Forest",975567,8,5001,980576,5009,0.51
"192","Mediterranean California Red Fir Forest - Cascades",1048945,1,8794,1057739,8794,0.83
"193","Mediterranean California Red Fir Forest - Southern Sierra",1355260,0,4306,1359567,4307,0.32
"194","Mediterranean California Sparsely Vegetated Systems",NA,230,1524,1754,NA,NA
"195","Mediterranean California Subalpine Meadow",12954,NA,34,12988,34,0.26
"196","Mediterranean California Subalpine Woodland",586768,NA,149,586917,149,0.03
"197","Middle Rocky Mountain Montane Douglas-fir Forest and Woodland",6580407,10456,22522,6613385,32978,0.5
"198","Middle Rocky Mountain Montane Douglas-fir Forest and Woodland - Fire-maintained Savanna",147161,589,1974,149724,2563,1.71
"199","Mississippi Delta Maritime Forest",65,NA,NA,65,0,0
"200","Mississippi River Alluvial Plain Dry-Mesic Loess Slope Forest",69281,35676,14471,119428,50147,41.99
"201","Mogollon Chaparral",4452610,3598,37035,4493243,40633,0.9
"202","Mojave Mid-Elevation Mixed Desert Scrub",12248933,8024,252942,12509899,260966,2.09
"203","Nashville Basin Limestone Glade and Woodland",115877,94041,61240,271157,155280,57.27
"204","North-Central Interior Beech-Maple Forest",2677300,14534319,4183527,21395147,18717847,87.49
"205","North-Central Interior Dry-Mesic Oak Forest and Woodland",7295116,20634513,6699139,34628767,27333651,78.93
"206","North-Central Interior Dry Oak Forest and Woodland",2144024,2533002,921651,5598677,3454653,61.7
"207","North-Central Interior Maple-Basswood Forest",3244182,6712919,2237051,12194153,8949971,73.4
"208","North-Central Interior Oak Savanna",4894298,7395060,2740755,15030112,10135814,67.44
"209","North-Central Interior Sand and Gravel Tallgrass Prairie",488125,1927193,851121,3266438,2778313,85.06
"210","North-Central Interior Wet Flatwoods",606152,711319,423221,1740692,1134540,65.18
"211","North-Central Oak Barrens",885079,1446912,975283,3307274,2422195,73.24
"212","North American Warm Desert Riparian Systems",2176150,420467,292803,2889420,713270,24.69
"213","North American Warm Desert Riparian Systems - Stringers",1994874,11774,83588,2090237,95363,4.56
"214","North American Warm Desert Sparsely Vegetated Systems",720965,65156,93227,879348,158383,18.01
"215","North Pacific Alpine and Subalpine Dry Grassland",171912,NA,462,172374,462,0.27
"216","North Pacific Avalanche Chute Shrubland",36297,NA,36,36333,36,0.1
"217","North Pacific Broadleaf Landslide Forest and Shrubland",60915,340,3615,64869,3954,6.1
"218","North Pacific Dry-Mesic Silver Fir-Western Hemlock-Douglas-fir Forest",1605919,3,22706,1628628,22709,1.39
"219","North Pacific Dry and Mesic Alpine Dwarf-Shrubland or Fell-field or Meadow",276438,24,583,277045,607,0.22
"220","North Pacific Dry Douglas-fir(-Madrone) Forest and Woodland",400917,129378,131917,662212,261295,39.46
"221","North Pacific Hypermaritime Sitka Spruce Forest",2187121,20471,171955,2379547,192426,8.09
"222","North Pacific Hypermaritime Western Red-cedar-Western Hemlock Forest",1276124,28261,135480,1439864,163740,11.37
"223","North Pacific Lowland Riparian Forest and Shrubland",1142187,400655,398970,1941811,799624,41.18
"224","North Pacific Maritime Dry-Mesic Douglas-fir-Western Hemlock Forest",4881742,89744,482783,5454268,572526,10.5
"225","North Pacific Maritime Mesic-Wet Douglas-fir-Western Hemlock Forest",7728802,309615,882477,8920894,1192092,13.36
"226","North Pacific Maritime Mesic Subalpine Parkland",202646,1,382,203029,383,0.19
"227","North Pacific Mesic Western Hemlock-Silver Fir Forest",2692250,1,56359,2748610,56360,2.05
"228","North Pacific Montane Grassland",104066,752,5810,110628,6562,5.93
"229","North Pacific Montane Riparian Woodland and Shrubland - Dry",189144,1939,13936,205018,15874,7.74
"230","North Pacific Montane Riparian Woodland and Shrubland - Wet",519354,7255,32635,559244,39890,7.13
"231","North Pacific Montane Shrubland",48880,333,824,50037,1157,2.31
"232","North Pacific Mountain Hemlock Forest - Wet",852932,NA,4674,857606,4674,0.55
"233","North Pacific Mountain Hemlock Forest - Xeric",853600,13,3049,856661,3061,0.36
"234","North Pacific Oak Woodland",557027,379495,209616,1146138,589111,51.4
"235","North Pacific Sparsely Vegetated Systems",NA,NA,28,28,NA,NA
"236","North Pacific Swamp Systems",90667,2537,12271,105475,14808,14.04
"237","North Pacific Wooded Volcanic Flowage",5585,0,162,5747,162,2.82
"238","Northeastern Interior Dry-Mesic Oak Forest",16434960,6826432,5451940,28713332,12278372,42.76
"239","Northeastern Interior Pine Barrens",143579,14612,69551,227742,84163,36.96
"240","Northern and Central California Dry-Mesic Chaparral",4140348,42258,210453,4393059,252711,5.75
"241","Northern Atlantic Coastal Plain Dune and Swale",173241,7116,64128,244485,71244,29.14
"242","Northern Atlantic Coastal Plain Hardwood Forest",1742106,474492,1854464,4071062,2328956,57.21
"243","Northern Atlantic Coastal Plain Maritime Forest",97946,41044,94086,233077,135131,57.98
"244","Northern Atlantic Coastal Plain Pitch Pine Barrens",742335,52148,395751,1190234,447899,37.63
"245","Northern California Coastal Scrub",125226,399,99918,225543,100317,44.48
"246","Northern California Mesic Subalpine Woodland",48253,0,208,48461,208,0.43
"247","Northern Crowley`s Ridge Sand Forest",168194,157659,61478,387331,219137,56.58
"248","Northern Rocky Mountain Conifer Swamp",450292,1066,6489,457846,7554,1.65
"249","Northern Rocky Mountain Dry-Mesic Montane Mixed Conifer Forest",6474317,364382,161937,7000637,526320,7.52
"250","Northern Rocky Mountain Dry-Mesic Montane Mixed Conifer Forest - Grand Fir",3482936,32583,29527,3545046,62110,1.75
"251","Northern Rocky Mountain Dry-Mesic Montane Mixed Conifer Forest - Larch",2089837,6575,19484,2115896,26059,1.23
"252","Northern Rocky Mountain Dry-Mesic Montane Mixed Conifer Forest - Lodgepole Pine",185608,26,210,185844,236,0.13
"253","Northern Rocky Mountain Dry-Mesic Montane Mixed Conifer Forest - Ponderosa Pine-Douglas-fir",8440633,83472,133000,8657106,216473,2.5
"254","Northern Rocky Mountain Foothill Conifer Wooded Steppe",142639,3970,3613,150223,7584,5.05
"255","Northern Rocky Mountain Lower Montane-Foothill-Valley Grassland",4405134,449228,356049,5210412,805278,15.46
"256","Northern Rocky Mountain Mesic Montane Mixed Conifer Forest",4929067,13790,45913,4988769,59702,1.2
"257","Northern Rocky Mountain Mesic Montane Mixed Conifer Forest - Cedar Groves",22571,0,185,22757,186,0.82
"258","Northern Rocky Mountain Montane-Foothill Deciduous Shrubland",662938,391594,50471,1105002,442064,40.01
"259","Northern Rocky Mountain Ponderosa Pine Woodland and Savanna",2446280,52535,61349,2560164,113884,4.45
"260","Northern Rocky Mountain Ponderosa Pine Woodland and Savanna - Mesic",3186198,386888,90647,3663732,477534,13.03
"261","Northern Rocky Mountain Ponderosa Pine Woodland and Savanna - Xeric",1240780,1690,6166,1248635,7855,0.63
"262","Northern Rocky Mountain Subalpine-Upper Montane Grassland",290829,33263,5370,329461,38632,11.73
"263","Northern Rocky Mountain Subalpine Woodland and Parkland",6511801,97,2254,6514151,2350,0.04
"264","Northern Sugar Maple-Basswood Forest",95589,2149,3495,101233,5644,5.58
"265","Northern Tallgrass Prairie",2280635,27929568,5343882,35554085,33273450,93.59
"266","Northwestern Great Plains-Black Hills Ponderosa Pine Woodland and Savanna",320293,156963,52091,529346,209053,39.49
"267","Northwestern Great Plains-Black Hills Ponderosa Pine Woodland and Savanna - Low Elevation Woodland",1387191,3330,2391,1392912,5721,0.41
"268","Northwestern Great Plains-Black Hills Ponderosa Pine Woodland and Savanna - Savanna",1884880,7802,7849,1900531,15651,0.82
"269","Northwestern Great Plains Aspen Forest and Parkland",2470,47,211,2728,258,9.46
"270","Northwestern Great Plains Canyon",92,634,1461,2187,2095,95.79
"271","Northwestern Great Plains Highland White Spruce Woodland",89219,52,1955,91226,2007,2.2
"272","Northwestern Great Plains Mixedgrass Prairie",65082286,35879322,11706324,112667932,47585646,42.24
"273","Northwestern Great Plains Shrubland",3527154,42727,103744,3673626,146472,3.99
"274","Ouachita Montane Oak Forest",7060,60,913,8033,973,12.11
"275","Ozark-Ouachita Dry-Mesic Oak Forest",6199415,3186535,915444,10301395,4101980,39.82
"276","Ozark-Ouachita Dry Oak Woodland",8917609,4141018,1328034,14386660,5469051,38.01
"277","Ozark-Ouachita Mesic Hardwood Forest",1336389,157273,90695,1584357,247968,15.65
"278","Ozark-Ouachita Shortleaf Pine-Bluestem Woodland",2627198,678121,347524,3652844,1025646,28.08
"279","Ozark-Ouachita Shortleaf Pine-Oak Forest and Woodland",3694128,589037,398501,4681666,987538,21.09
"280","Pacific Coastal Marsh Systems",53043,8673,41201,102916,49873,48.46
"281","Paleozoic Plateau Bluff and Talus",742439,544720,207245,1494405,751966,50.32
"282","Pennyroyal Karst Plain Prairie and Barrens",8732,15265,4469,28466,19734,69.32
"283","Piedmont Hardpan Woodland and Forest",12044,9574,15453,37071,25027,67.51
"284","Rocky Mountain Alpine Dwarf-Shrubland",149948,36,284,150268,320,0.21
"285","Rocky Mountain Alpine Fell-Field",359501,32,200,359733,232,0.06
"286","Rocky Mountain Alpine Turf",305029,21376,25888,352293,47264,13.42
"287","Rocky Mountain Alpine/Montane Sparsely Vegetated Systems",3495,980,1496,5971,2476,41.47
"288","Rocky Mountain Aspen Forest and Woodland",6596295,55762,59330,6711387,115092,1.71
"289","Rocky Mountain Bigtooth Maple Ravine Woodland",545510,15119,17508,578137,32627,5.64
"290","Rocky Mountain Foothill Limber Pine-Juniper Woodland",519317,4156,9606,533079,13762,2.58
"291","Rocky Mountain Gambel Oak-Mixed Montane Shrubland",3387885,77351,168315,3633551,245666,6.76
"292","Rocky Mountain Gambel Oak-Mixed Montane Shrubland - Patchy",356054,4797,13149,374000,17946,4.8
"293","Rocky Mountain Gambel Oak-Mixed Montane Shrubland  - Continuous",733148,2588,11814,747551,14403,1.93
"294","Rocky Mountain Lodgepole Pine Forest",2050001,6541,36918,2093460,43459,2.08
"295","Rocky Mountain Lower Montane-Foothill Shrubland",1400044,97536,153466,1651046,251002,15.2
"296","Rocky Mountain Lower Montane-Foothill Shrubland - No True Mountain Mahogany",26985,36,705,27726,741,2.67
"297","Rocky Mountain Lower Montane-Foothill Shrubland - True Mountain Mahogany",5162,2,61,5226,64,1.22
"298","Rocky Mountain Montane Riparian Systems",10137956,1759492,1473888,13371336,3233380,24.18
"299","Rocky Mountain Poor-Site Lodgepole Pine Forest",1380850,4018,27880,1412749,31899,2.26
"300","Rocky Mountain Subalpine-Montane Limber-Bristlecone Pine Woodland",196200,149,3532,199880,3680,1.84
"301","Rocky Mountain Subalpine-Montane Mesic Meadow",717150,5311,14164,736625,19475,2.64
"302","Rocky Mountain Subalpine Dry-Mesic Spruce-Fir Forest and Woodland",15699836,20824,61649,15782308,82472,0.52
"303","Rocky Mountain Subalpine Mesic-Wet Spruce-Fir Forest and Woodland",9495469,15347,27158,9537975,42506,0.45
"304","Rocky Mountain Subalpine/Upper Montane Riparian Systems",2603924,224152,246793,3074869,470945,15.32
"305","Sierra Nevada Alpine Dwarf-Shrubland",25859,NA,21,25880,21,0.08
"306","Sierra Nevada Subalpine Lodgepole Pine Forest and Woodland",37296,4,42,37341,45,0.12
"307","Sierra Nevada Subalpine Lodgepole Pine Forest and Woodland - Dry",73107,NA,74,73181,74,0.1
"308","Sierra Nevada Subalpine Lodgepole Pine Forest and Woodland - Wet",159828,1,1743,161572,1744,1.08
"309","Sierran-Intermontane Desert Western White Pine-White Fir Woodland",143941,24,49,144014,73,0.05
"310","Sonora-Mojave Creosotebush-White Bursage Desert Scrub",24570265,693274,1191772,26455311,1885046,7.13
"311","Sonora-Mojave Mixed Salt Desert Scrub",1216114,3013342,770290,4999746,3783632,75.68
"312","Sonora-Mojave Semi-Desert Chaparral",1724208,89918,116736,1930862,206654,10.7
"313","Sonoran Granite Outcrop Desert Scrub",5471362,55413,345830,5872605,401243,6.83
"314","Sonoran Mid-Elevation Desert Scrub",2398272,1877,34919,2435069,36797,1.51
"315","Sonoran Paloverde-Mixed Cacti Desert Scrub",2314401,92982,147740,2555122,240721,9.42
"316","South-Central Interior Large Floodplain",761094,803512,165462,1730069,968975,56.01
"317","South-Central Interior Mesophytic Forest",13875114,4941681,2440627,21257422,7382308,34.73
"318","South-Central Interior/Upper Coastal Plain Flatwoods",34039,72788,15075,121901,87862,72.08
"319","South-Central Interior/Upper Coastal Plain Wet Flatwoods",27410,58075,14423,99908,72498,72.56
"320","South Florida Cypress Dome",92107,1399,2296,95802,3695,3.86
"321","South Florida Dwarf Cypress Savanna",47203,0,474,47677,474,0.99
"322","South Florida Everglades Sawgrass Marsh",2178168,586657,435159,3199984,1021816,31.93
"323","South Florida Hardwood Hammock",5370,31390,153313,190073,184703,97.17
"324","South Florida Pine Flatwoods",568019,411446,498212,1477677,909658,61.56
"325","South Florida Pine Rockland",19864,15588,120446,155898,136034,87.26
"326","South Texas Lomas",25461,3497,3506,32464,7003,21.57
"327","South Texas Sand Sheet Grassland",729817,62456,194545,986818,257001,26.04
"328","Southeast Florida Coastal Strand and Maritime Hammock",6883,202,61178,68263,61380,89.92
"329","Southeastern Great Plains Tallgrass Prairie",9280643,12849844,4730388,26860875,17580232,65.45
"330","Southeastern Interior Longleaf Pine Woodland",509441,55065,96763,661269,151828,22.96
"331","Southern and Central Appalachian Cove Forest",2319639,241667,271563,2832869,513230,18.12
"332","Southern Appalachian Grass and Shrub Bald",1994,82,301,2377,383,16.11
"333","Southern Appalachian Low-Elevation Pine Forest",1053881,196777,155295,1405953,352072,25.04
"334","Southern Appalachian Montane Pine Forest and Woodland",623697,11099,24711,659507,35810,5.43
"335","Southern Appalachian Northern Hardwood Forest",254039,1585,9671,265294,11255,4.24
"336","Southern Appalachian Oak Forest",4764941,401558,552251,5718749,953808,16.68
"337","Southern Atlantic Coastal Plain Dune and Maritime Grassland",1536,1161,5261,7957,6421,80.7
"338","Southern Atlantic Coastal Plain Maritime Forest",110509,774,29686,140969,30460,21.61
"339","Southern Atlantic Coastal Plain Wet Pine Savanna and Flatwoods",2623001,144678,755918,3523596,900595,25.56
"340","Southern Blackland Tallgrass Prairie",2676593,4275610,2828260,9780463,7103870,72.63
"341","Southern California Coastal Scrub",1462064,64313,2104705,3631082,2169018,59.73
"342","Southern California Dry-Mesic Chaparral",2082316,965,302256,2385537,303221,12.71
"343","Southern California Oak Woodland and Savanna",560271,5065,89113,654449,94178,14.39
"344","Southern Coastal Plain Blackland Prairie and Woodland",620471,358700,174145,1153316,532845,46.2
"345","Southern Coastal Plain Dry Upland Hardwood Forest",5733968,954775,948552,7637295,1903327,24.92
"346","Southern Coastal Plain Mesic Slope Forest",4951201,1571600,1247440,7770241,2819040,36.28
"347","Southern Coastal Plain Nonriverine Cypress Dome",1174775,29127,69497,1273399,98624,7.74
"348","Southern Coastal Plain Seepage Swamp and Baygall",2431616,67248,149772,2648635,217019,8.19
"349","Southern Colorado Plateau Sand Shrubland",2053351,24154,23623,2101128,47777,2.27
"350","Southern Crowley`s Ridge Mesic Loess Slope Forest",70840,13401,9790,94032,23192,24.66
"351","Southern Interior Low Plateau Dry-Mesic Oak Forest",9797836,6500834,1893718,18192389,8394553,46.14
"352","Southern Piedmont Dry Oak(-Pine) Forest",16456458,4262785,5730299,26449542,9993084,37.78
"353","Southern Piedmont Mesic Forest",6170407,988970,1289086,8448464,2278057,26.96
"354","Southern Ridge and Valley/Cumberland Dry Calcareous Forest",2361545,975495,682612,4019652,1658107,41.25
"355","Southern Rocky Mountain Dry-Mesic Montane Mixed Conifer Forest and Woodland",3880278,5538,25111,3910926,30648,0.78
"356","Southern Rocky Mountain Juniper Woodland and Savanna",3919999,21064,64320,4005383,85384,2.13
"357","Southern Rocky Mountain Mesic Montane Mixed Conifer Forest and Woodland",2263906,1067,13095,2278068,14162,0.62
"358","Southern Rocky Mountain Montane-Subalpine Grassland",1153261,3996,16405,1173663,20402,1.74
"359","Southern Rocky Mountain Pinyon-Juniper Woodland",2648717,1251,19754,2669722,21005,0.79
"360","Southern Rocky Mountain Ponderosa Pine Savanna",3383440,3360,29561,3416361,32921,0.96
"361","Southern Rocky Mountain Ponderosa Pine Savanna - North",5866,3,800,6669,803,12.04
"362","Southern Rocky Mountain Ponderosa Pine Savanna - South",192,0,0,193,1,0.52
"363","Southern Rocky Mountain Ponderosa Pine Woodland",9975374,34900,130989,10141263,165889,1.64
"364","Southern Rocky Mountain Ponderosa Pine Woodland - North",111923,140,19787,131850,19927,15.11
"365","Southern Rocky Mountain Ponderosa Pine Woodland - South",314595,568,4345,319508,4913,1.54
"366","Southwest Florida Coastal Strand and Maritime Hammock",17327,4441,92037,113805,96478,84.77
"367","Tamaulipan Calcareous Thornscrub",1411082,83640,187930,1682652,271570,16.14
"368","Tamaulipan Clay Grassland",10493,7787,3146,21426,10933,51.03
"369","Tamaulipan Floodplain",2306,399,200,2905,599,20.62
"370","Tamaulipan Mixed Deciduous Thornscrub",4984960,2188398,1519904,8693262,3708302,42.66
"371","Tamaulipan Riparian Systems",1349716,467161,346065,2162943,813227,37.6
"372","Tamaulipan Savanna Grassland",2756598,896268,881630,4534497,1777899,39.21
"373","Texas-Louisiana Coastal Prairie",1220329,5722354,2065939,9008621,7788292,86.45
"374","Texas-Louisiana Saline Coastal Prairie",154675,61681,56723,273080,118405,43.36
"375","West Gulf Coastal Plain Chenier and Upper Texas Coastal Fringe Forest and Woodland",44868,9825,20698,75392,30524,40.49
"376","West Gulf Coastal Plain Mesic Hardwood Forest",1551647,178936,177046,1907628,355981,18.66
"377","West Gulf Coastal Plain Nonriverine Wet Hardwood Flatwoods",876234,73261,118105,1067600,191366,17.92
"378","West Gulf Coastal Plain Northern Calcareous Prairie",102343,114361,34261,250965,148622,59.22
"379","West Gulf Coastal Plain Pine-Hardwood Flatwoods",1786504,218097,465445,2470046,683542,27.67
"380","West Gulf Coastal Plain Pine-Hardwood Forest",7799244,1720306,1674971,11194521,3395277,30.33
"381","West Gulf Coastal Plain Sandhill Oak and Shortleaf Pine Forest and Woodland",345284,182355,108706,636345,291061,45.74
"382","West Gulf Coastal Plain Southern Calcareous Prairie",86641,85449,56132,228222,141581,62.04
"383","West Gulf Coastal Plain Upland Longleaf Pine Forest and Woodland",2070683,124263,368887,2563832,493149,19.23
"384","West Gulf Coastal Plain Wet Longleaf Pine Savanna and Flatwoods",2950348,342004,573940,3866292,915944,23.69
"385","Western Great Plains Depressional Wetland Systems",2157153,913452,419022,3489627,1332474,38.18
"386","Western Great Plains Depressional Wetland Systems - Playa",211064,117267,55083,383414,172350,44.95
"387","Western Great Plains Depressional Wetland Systems - Saline",10081,8026,3023,21130,11049,52.29
"388","Western Great Plains Dry Bur Oak Forest and Woodland",1433180,267687,133965,1834832,401652,21.89
"389","Western Great Plains Floodplain Systems",12191663,4694833,2529056,19415552,7223889,37.21
"390","Western Great Plains Foothill and Piedmont Grassland",2830480,65729,192564,3088773,258293,8.36
"391","Western Great Plains Mesquite Woodland and Shrubland",1104723,96143,60922,1261788,157065,12.45
"392","Western Great Plains Sand Prairie",19554547,5775923,1771300,27101770,7547223,27.85
"393","Western Great Plains Sandhill Steppe",10894369,1911287,994437,13800093,2905724,21.06
"394","Western Great Plains Shortgrass Prairie",38849205,15688253,5804000,60341458,21492253,35.62
"395","Western Great Plains Sparsely Vegetated Systems",15650,14567,9272,39489,23839,60.37
"396","Western Great Plains Tallgrass Prairie",1165659,1430374,330103,2926136,1760477,60.16
"397","Western Great Plains Wooded Draw and Ravine",1720282,329564,159407,2209253,488971,22.13
"398","Western Highland Rim Prairie and Barrens",7895,2283,827,11006,3111,28.27
"399","Willamette Valley Upland Prairie and Savanna",120270,790975,263870,1175115,1054845,89.77
"400","Wyoming Basins Dwarf Sagebrush Shrubland and Steppe",72638,15115,22448,110200,37562,34.09
